111111111111111
1P0000000000001
100000000C00001
1000E0000000001
111111111111111
